_______________
_______________
__BiY_____Fi!__
_______________
__wwwwwwwwwww__
_______r_______
___b___r___f___
_______r_______
__wwwwwwwwwww__
_______________
__WiS_____RiP__
_______________
_______________