____wwwwwwww
____w______w
____w_i____w
____w______w
wwwww___!__w
w__________w
w_F___f____w
w__________w
wwwwwwwwwwww
____w______w
_B__w_W____w
_i__w_i__b_w
_Y__w_S____w
____w______w
____wwwwwwww