____ffffffff
____f______f
____f_i____f
____f______f
fffff___!__f
f__________f
f_B________f
f__________f
ffffffffffff
____f______f
_W__f_F____f
_i__f_i__w_f
_Y__f_S____f
____f___ffff
____fffff___