Fi!___o_______o_______o_
BiY_____o___o___o___o___
________________________
_____________kkkkkkkkk__
_____________k_______k__
__RiP________k_K_____k__
_____________k_i_____k__
_____k_k_____k_X_____k__
_____krk_____k_______k__
___kkkrkkk___k____f__k__
___k__r__k___k_______k__
___k_____k___kkkkkkkkk__
___k__b__k______________
___k_____k______________